20 20 20 20 20 20 60 30 30 30 30 30 30 60 40 40 40 40 40 40
20 20 20 20 20 20 60 30 30 30 30 30 30 60 40 40 40 40 40 40
20 20 20 20 20 20 60 30 30 30 30 30 30 60 40 40 40 40 40 40
20 20 20 20 20 20 60 30 30 30 30 30 30 60 40 40 40 40 40 40
20 20 20 20 20 20 60 30 30 30 30 30 30 60 40 40 40 40 40 40
20 20 20 20 20 20 20 30 30 30 30 30 30 60 40 40 40 40 40 40
20 20 20 20 20 20 20 30 30 30 30 30 30 60 40 40 40 40 40 40
20 20 20 20 20 20 20 30 30 30 30 30 30 60 40 40 40 40 40 40
20 20 20 20 20 20 60 30 30 30 30 30 30 60 40 40 40 40 40 40
20 20 20 20 20 20 60 30 30 30 30 30 30 60 40 40 40 40 40 40
20 20 20 20 20 20 60 30 30 30 30 30 30 60 40 40 40 40 40 40
20 20 20 20 20 20 60 30 30 30 30 30 30 60 40 40 40 40 40 40
20 20 20 20 20 20 60 30 30 30 30 30 30 60 40 40 40 40 40 40
20 20 20 20 20 20 60 30 30 30 30 30 30 60 40 40 40 40 40 40
20 20 20 20 20 20 60 30 30 30 30 30 30 60 40 40 40 40 40 40
20 20 20 20 20 20 60 30 30 30 30 30 30 30 40 40 40 40 40 40
20 20 20 20 20 20 60 30 30 30 30 30 30 30 40 40 40 40 40 40
20 20 20 20 20 20 60 30 30 30 30 30 30 60 40 40 40 40 40 40
20 20 20 20 20 20 60 30 30 30 30 30 30 60 40 40 40 40 40 40
20 20 20 20 20 20 60 30 30 30 30 30 30 60 40 40 40 40 40 40