20 20 20 20 20 20 20 20 20 20 60 30 30 30 30 30 30 30 30 30
20 20 20 20 20 20 20 20 20 20 60 30 30 30 30 30 30 30 30 30
20 20 20 20 20 20 20 20 20 20 20 30 30 30 30 30 30 30 30 30
20 20 20 20 20 20 20 20 20 20 60 30 30 30 30 30 30 30 30 30
20 20 20 20 20 20 20 20 20 20 60 30 30 30 30 30 30 30 30 30
20 20 20 20 20 20 20 20 20 20 60 30 30 30 30 30 30 30 30 30
20 20 20 20 20 20 20 20 20 20 60 60 60 60 30 30 30 60 60 60
20 20 20 20 20 20 20 60 60 60 40 40 40 40 40 40 40 40 40 40
20 20 20 20 20 20 20 60 40 40 40 40 40 40 40 40 40 40 40 40
20 20 20 20 20 20 20 60 40 40 40 40 40 40 40 40 40 40 40 40
20 20 20 20 20 20 20 60 40 40 40 40 40 40 40 40 40 40 40 40
20 20 20 20 20 20 20 60 40 40 40 40 40 40 40 40 40 40 40 40
20 20 20 20 20 20 20 60 40 40 40 40 40 40 40 40 40 40 40 40
20 20 20 20 20 20 20 60 40 40 40 40 40 40 40 40 40 40 40 40
20 20 20 20 20 20 20 60 40 40 40 40 40 40 40 40 40 40 40 40
20 20 20 20 20 20 20 40 40 40 40 40 40 40 40 40 40 40 40 40
20 20 20 20 20 20 20 60 40 40 40 40 40 40 40 40 40 40 40 40
20 20 20 20 20 20 20 60 40 40 40 40 40 40 40 40 40 40 40 40
20 20 20 20 20 20 20 60 40 40 40 40 40 40 40 40 40 40 40 40
20 20 20 20 20 20 20 60 40 40 40 40 40 40 40 40 40 40 40 40